Verification of CM010A_GmT1xxMcuCfg_DataDict
06-Dec-2016 14:45:45
Tool Release:  2.49.0



--------------------------------
DATA CLASS VIOLATION CHECKS
--------------------------------
(errors: 0)

---------------------------------------------------------------
FDD DEFINITION VARIABLE:	<Type><Number><Variant>  e.g. SF099A
--------------------------------------------------------------
CM010A              	1xx		Unknown Keyword used.Only Nxtr approved Keywords should be used.
(variable: 1, errors: 1)

----------------------------
DATA DICTIONARY FILENAME:
----------------------------
(errors:  0)

------------------------------------------------------------
RUNNABLE:	<ShoName>Per<Number>  or  <ShoName>Init<Number>
------------------------------------------------------------
GmT1xxMcuCfgInit1           	    1xx            Unknown Keyword used.Only Nxtr approved Keywords should be used.
GmT1xxMcuCfgInit2           	    1xx            Unknown Keyword used.Only Nxtr approved Keywords should be used.
GmT1xxMcuCfgInit3           	    1xx            Unknown Keyword used.Only Nxtr approved Keywords should be used.
GmT1xxMcuCfgPer1            	    1xx            Unknown Keyword used.Only Nxtr approved Keywords should be used.
GmT1xxMcuCfgPer2            	    1xx            Unknown Keyword used.Only Nxtr approved Keywords should be used.
GmT1xxMcuCfgPer3            	    1xx            Unknown Keyword used.Only Nxtr approved Keywords should be used.
(variables: 6, errors: 6)

--------------------------------------
SrvRunnable:	<TriggerName>
--------------------------------------
(variables: 0, errors: 0)

-----------------------
Client:	<TriggerName>
-------------------------
(variables: 2, errors: 0)

----------------------------
INPUT SIGNALS:	<Identity>
----------------------------
Adc1RawRes                  	Name does not match required pattern. Correct format is MotCtrl<Identity>.
(variables: 28, errors: 1)

-----------------------------
OUTPUT SIGNALS:	<Identity>
-----------------------------
BattVltgSwd2AdcFaild        	Cannot match name to list of known Nxtr signals.
MotAg2CosAdcFaild           	Cannot match name to list of known Nxtr signals.
MotAg2SinAdcFaild           	Cannot match name to list of known Nxtr signals.
MotCurrAdcPeakDAdcFaild     	Cannot match name to list of known Nxtr signals.
MotCurrAdcPeakEAdcFaild     	Cannot match name to list of known Nxtr signals.
MotCurrAdcPeakFAdcFaild     	Cannot match name to list of known Nxtr signals.
MotCurrAdcVlyDAdcFaild      	Cannot match name to list of known Nxtr signals.
MotCurrAdcVlyEAdcFaild      	Cannot match name to list of known Nxtr signals.
MotCurrAdcVlyFAdcFaild      	Cannot match name to list of known Nxtr signals.
MotCurrSnsrOffs2AdcFaild    	Cannot match name to list of known Nxtr signals.
(variables: 54, errors: 10)

---------------------------------------
INTER-RUNNABLE VARIABLES:	<Identity>
---------------------------------------
(variables: 0, errors: 0)

------------------------------------
CALIBRATIONS:	<ShoName><Identity>
------------------------------------
(variables: 0, errors: 0)

----------------------------------------------
IMPORTED CALIBRATIONS:	<ShoName><Identity>
---------------------------------------------
(variables: 0, errors: 0)

-------------------------------------------
NON-VOLATILE MEMORY:	<Identity>
-------------------------------------------
(variables: 0, errors: 0)

------------------------------------------
DISPLAY VARIABLES:	d<ShoName><Identity>
------------------------------------------
(variables: 0, errors: 0)

-----------------------------------------------
PER-INSTANCE MEMORY:	<Identity>
-----------------------------------------------
(variables: 0, errors: 0)

--------------------------------------------------------------------------------------------
CONSTANTS:	(ALL CAPS) required: 
						 For "Global" CONSTANTS --- <SHONAME>_<IDENTITY>_<UNITS>_<DATATYPE>
						 For "Local" CONSTANTS  --- <IDENTITY>_<UNITS>_<DATATYPE>
-------------------------------------------------------------------------------------------
ADC0CFGANDUSE_ADCD0SGVCEP2_CNT_U08	Name does not match required pattern.
ADC0CFGANDUSE_ADCD0SGVCEP3_CNT_U08	Name does not match required pattern.
ADC0CFGANDUSE_ADCD0SGVCSP2_CNT_U08	Name does not match required pattern.
ADC0CFGANDUSE_ADCD0SGVCSP3_CNT_U08	Name does not match required pattern.
ADC0CFGANDUSE_ADCD0VCR00_CNT_U32 	Name does not match required pattern.
ADC0CFGANDUSE_ADCD0VCR01_CNT_U32 	Name does not match required pattern.
ADC0CFGANDUSE_ADCD0VCR02_CNT_U32 	Name does not match required pattern.
ADC0CFGANDUSE_ADCD0VCR03_CNT_U32 	Name does not match required pattern.
ADC0CFGANDUSE_ADCD0VCR04_CNT_U32 	Name does not match required pattern.
ADC0CFGANDUSE_ADCD0VCR05_CNT_U32 	Name does not match required pattern.
ADC0CFGANDUSE_ADCD0VCR06_CNT_U32 	Name does not match required pattern.
ADC0CFGANDUSE_ADCD0VCR07_CNT_U32 	Name does not match required pattern.
ADC0CFGANDUSE_ADCD0VCR08_CNT_U32 	Name does not match required pattern.
ADC0CFGANDUSE_ADCD0VCR09_CNT_U32 	Name does not match required pattern.
ADC0CFGANDUSE_ADCD0VCR10_CNT_U32 	Name does not match required pattern.
ADC0CFGANDUSE_ADCD0VCR11_CNT_U32 	Name does not match required pattern.
ADC0CFGANDUSE_ADCD0VCR12_CNT_U32 	Name does not match required pattern.
ADC0CFGANDUSE_ADCD0VCR13_CNT_U32 	Name does not match required pattern.
ADC0CFGANDUSE_ADCD0VCR14_CNT_U32 	Name does not match required pattern.
ADC0CFGANDUSE_ADCD0VCR15_CNT_U32 	Name does not match required pattern.
ADC0CFGANDUSE_ADCD0VCR16_CNT_U32 	Name does not match required pattern.
ADC0CFGANDUSE_ADCD0VCR17_CNT_U32 	Name does not match required pattern.
ADC0CFGANDUSE_ADCD0VCR18_CNT_U32 	Name does not match required pattern.
ADC0CFGANDUSE_ADCD0VCR19_CNT_U32 	Name does not match required pattern.
ADC0CFGANDUSE_ADCD0VCR20_CNT_U32 	Name does not match required pattern.
ADC0CFGANDUSE_ADCSCAGFAC_VOLTPERCNT_F32	Name does not match required pattern.
ADC1CFGANDUSE_ADCD1SGVCEP2_CNT_U08	Name does not match required pattern.
ADC1CFGANDUSE_ADCD1SGVCEP3_CNT_U08	Name does not match required pattern.
ADC1CFGANDUSE_ADCD1SGVCSP2_CNT_U08	Name does not match required pattern.
ADC1CFGANDUSE_ADCD1SGVCSP3_CNT_U08	Name does not match required pattern.
ADC1CFGANDUSE_ADCD1VCR00_CNT_U32 	Name does not match required pattern.
ADC1CFGANDUSE_ADCD1VCR01_CNT_U32 	Name does not match required pattern.
ADC1CFGANDUSE_ADCD1VCR02_CNT_U32 	Name does not match required pattern.
ADC1CFGANDUSE_ADCD1VCR03_CNT_U32 	Name does not match required pattern.
ADC1CFGANDUSE_ADCD1VCR04_CNT_U32 	Name does not match required pattern.
ADC1CFGANDUSE_ADCD1VCR05_CNT_U32 	Name does not match required pattern.
ADC1CFGANDUSE_ADCD1VCR06_CNT_U32 	Name does not match required pattern.
ADC1CFGANDUSE_ADCD1VCR07_CNT_U32 	Name does not match required pattern.
ADC1CFGANDUSE_ADCD1VCR08_CNT_U32 	Name does not match required pattern.
ADC1CFGANDUSE_ADCD1VCR09_CNT_U32 	Name does not match required pattern.
ADC1CFGANDUSE_ADCD1VCR10_CNT_U32 	Name does not match required pattern.
ADC1CFGANDUSE_ADCD1VCR11_CNT_U32 	Name does not match required pattern.
ADC1CFGANDUSE_ADCD1VCR12_CNT_U32 	Name does not match required pattern.
ADC1CFGANDUSE_ADCD1VCR13_CNT_U32 	Name does not match required pattern.
ADC1CFGANDUSE_ADCD1VCR14_CNT_U32 	Name does not match required pattern.
ADC1CFGANDUSE_ADCD1VCR15_CNT_U32 	Name does not match required pattern.
ADC1CFGANDUSE_ADCD1VCR16_CNT_U32 	Name does not match required pattern.
ADC1CFGANDUSE_ADCD1VCR17_CNT_U32 	Name does not match required pattern.
ADC1CFGANDUSE_ADCD1VCR18_CNT_U32 	Name does not match required pattern.
ADC1CFGANDUSE_ADCD1VCR19_CNT_U32 	Name does not match required pattern.
ADC1CFGANDUSE_ADCD1VCR20_CNT_U32 	Name does not match required pattern.
ADCDIAGC_DYNDIAGFAILSTEP_CNT_U16 	Name does not match required pattern.
ADCDIAGC_DYNDIAGPASSSTEP_CNT_U16 	Name does not match required pattern.
ADC0CFGANDUSE_ADCD0SGVCEP2_CNT_U08	Found in data dictionary but not in model.
ADC0CFGANDUSE_ADCD0SGVCEP3_CNT_U08	Found in data dictionary but not in model.
ADC0CFGANDUSE_ADCD0SGVCSP2_CNT_U08	Found in data dictionary but not in model.
ADC0CFGANDUSE_ADCD0SGVCSP3_CNT_U08	Found in data dictionary but not in model.
ADC0CFGANDUSE_ADCD0VCR00_CNT_U32	Found in data dictionary but not in model.
ADC0CFGANDUSE_ADCD0VCR01_CNT_U32	Found in data dictionary but not in model.
ADC0CFGANDUSE_ADCD0VCR02_CNT_U32	Found in data dictionary but not in model.
ADC0CFGANDUSE_ADCD0VCR03_CNT_U32	Found in data dictionary but not in model.
ADC0CFGANDUSE_ADCD0VCR04_CNT_U32	Found in data dictionary but not in model.
ADC0CFGANDUSE_ADCD0VCR05_CNT_U32	Found in data dictionary but not in model.
ADC0CFGANDUSE_ADCD0VCR06_CNT_U32	Found in data dictionary but not in model.
ADC0CFGANDUSE_ADCD0VCR07_CNT_U32	Found in data dictionary but not in model.
ADC0CFGANDUSE_ADCD0VCR08_CNT_U32	Found in data dictionary but not in model.
ADC0CFGANDUSE_ADCD0VCR09_CNT_U32	Found in data dictionary but not in model.
ADC0CFGANDUSE_ADCD0VCR10_CNT_U32	Found in data dictionary but not in model.
ADC0CFGANDUSE_ADCD0VCR11_CNT_U32	Found in data dictionary but not in model.
ADC0CFGANDUSE_ADCD0VCR12_CNT_U32	Found in data dictionary but not in model.
ADC0CFGANDUSE_ADCD0VCR13_CNT_U32	Found in data dictionary but not in model.
ADC0CFGANDUSE_ADCD0VCR14_CNT_U32	Found in data dictionary but not in model.
ADC0CFGANDUSE_ADCD0VCR15_CNT_U32	Found in data dictionary but not in model.
ADC0CFGANDUSE_ADCD0VCR16_CNT_U32	Found in data dictionary but not in model.
ADC0CFGANDUSE_ADCD0VCR17_CNT_U32	Found in data dictionary but not in model.
ADC0CFGANDUSE_ADCD0VCR18_CNT_U32	Found in data dictionary but not in model.
ADC0CFGANDUSE_ADCD0VCR19_CNT_U32	Found in data dictionary but not in model.
ADC0CFGANDUSE_ADCD0VCR20_CNT_U32	Found in data dictionary but not in model.
ADC0CFGANDUSE_ADCSCAGFAC_VOLTPERCNT_F32	Found in data dictionary but not in model.
ADC1CFGANDUSE_ADCD1SGVCEP2_CNT_U08	Found in data dictionary but not in model.
ADC1CFGANDUSE_ADCD1SGVCEP3_CNT_U08	Found in data dictionary but not in model.
ADC1CFGANDUSE_ADCD1SGVCSP2_CNT_U08	Found in data dictionary but not in model.
ADC1CFGANDUSE_ADCD1SGVCSP3_CNT_U08	Found in data dictionary but not in model.
ADC1CFGANDUSE_ADCD1VCR00_CNT_U32	Found in data dictionary but not in model.
ADC1CFGANDUSE_ADCD1VCR01_CNT_U32	Found in data dictionary but not in model.
ADC1CFGANDUSE_ADCD1VCR02_CNT_U32	Found in data dictionary but not in model.
ADC1CFGANDUSE_ADCD1VCR03_CNT_U32	Found in data dictionary but not in model.
ADC1CFGANDUSE_ADCD1VCR04_CNT_U32	Found in data dictionary but not in model.
ADC1CFGANDUSE_ADCD1VCR05_CNT_U32	Found in data dictionary but not in model.
ADC1CFGANDUSE_ADCD1VCR06_CNT_U32	Found in data dictionary but not in model.
ADC1CFGANDUSE_ADCD1VCR07_CNT_U32	Found in data dictionary but not in model.
ADC1CFGANDUSE_ADCD1VCR08_CNT_U32	Found in data dictionary but not in model.
ADC1CFGANDUSE_ADCD1VCR09_CNT_U32	Found in data dictionary but not in model.
ADC1CFGANDUSE_ADCD1VCR10_CNT_U32	Found in data dictionary but not in model.
ADC1CFGANDUSE_ADCD1VCR11_CNT_U32	Found in data dictionary but not in model.
ADC1CFGANDUSE_ADCD1VCR12_CNT_U32	Found in data dictionary but not in model.
ADC1CFGANDUSE_ADCD1VCR13_CNT_U32	Found in data dictionary but not in model.
ADC1CFGANDUSE_ADCD1VCR14_CNT_U32	Found in data dictionary but not in model.
ADC1CFGANDUSE_ADCD1VCR15_CNT_U32	Found in data dictionary but not in model.
ADC1CFGANDUSE_ADCD1VCR16_CNT_U32	Found in data dictionary but not in model.
ADC1CFGANDUSE_ADCD1VCR17_CNT_U32	Found in data dictionary but not in model.
ADC1CFGANDUSE_ADCD1VCR18_CNT_U32	Found in data dictionary but not in model.
ADC1CFGANDUSE_ADCD1VCR19_CNT_U32	Found in data dictionary but not in model.
ADC1CFGANDUSE_ADCD1VCR20_CNT_U32	Found in data dictionary but not in model.
ADCDIAGC_DYNDIAGFAILSTEP_CNT_U16	Found in data dictionary but not in model.
ADCDIAGC_DYNDIAGPASSSTEP_CNT_U16	Found in data dictionary but not in model.
ELECGLBPRM_IVTRCNT_CNT_U08  	Found in data dictionary but not in model.
ELECGLBPRM_PWMFRQMAX_HZ_U32 	Found in data dictionary but not in model.
ELECGLBPRM_PWMFRQMIN_HZ_U32 	Found in data dictionary but not in model.
ELECGLBPRM_PWMPERDMAX_NANOSEC_U32	Found in data dictionary but not in model.
ELECGLBPRM_PWMPERDMIN_NANOSEC_U32	Found in data dictionary but not in model.
ELECGLBPRM_PWMPERDNOMX2_SEC_F32	Found in data dictionary but not in model.
ELECGLBPRM_PWMPERDNOM_MICROSEC_U7P9	Found in data dictionary but not in model.
HWAG0IFNTCNR_ULS_U16        	Found in data dictionary but not in model.
HWAG0MFGNTCNR_ULS_U16       	Found in data dictionary but not in model.
HWAG0SNSR0PRTCLNTCNR_ULS_U16	Found in data dictionary but not in model.
HWAG0SNSR1PRTCLNTCNR_ULS_U16	Found in data dictionary but not in model.
HWAG1IFNTCNR_ULS_U16        	Found in data dictionary but not in model.
HWAG1MFGNTCNR_ULS_U16       	Found in data dictionary but not in model.
HWAG1SNSR0PRTCLNTCNR_ULS_U16	Found in data dictionary but not in model.
HWAG1SNSR1PRTCLNTCNR_ULS_U16	Found in data dictionary but not in model.
HWTQ0MEAS_HWTQ0MFGNTCNR_ULS_U16	Found in data dictionary but not in model.
HWTQ0MEAS_HWTQ0PRTCLNTCNR_ULS_U16	Found in data dictionary but not in model.
HWTQ1MEAS_HWTQ1MFGNTCNR_ULS_U16	Found in data dictionary but not in model.
HWTQ1MEAS_HWTQ1PRTCLNTCNR_ULS_U16	Found in data dictionary but not in model.
HWTQ2MEAS_HWTQ2MFGNTCNR_ULS_U16	Found in data dictionary but not in model.
HWTQ2MEAS_HWTQ2PRTCLNTCNR_ULS_U16	Found in data dictionary but not in model.
HWTQ3MEAS_HWTQ3MFGNTCNR_ULS_U16	Found in data dictionary but not in model.
HWTQ3MEAS_HWTQ3PRTCLNTCNR_ULS_U16	Found in data dictionary but not in model.
MOTAG0MEAS_MOTAG0PRTCLFLTNTCNR_CNT_ENUM	Found in data dictionary but not in model.
MOTAG1MEAS_MOTAG1PRTCLFLTNTCNR_CNT_ENUM	Found in data dictionary but not in model.
MOTAG2ANSINCOSFLTNTCNR_CNT_ENUM	Found in data dictionary but not in model.
TUNSELNAUTHY_XCPVEHSPDTHD_KPH_F32	Found in data dictionary but not in model.
(variables: 163, errors: 133)

-------------------------
CSArguments:	<IDENTITY>
---------------------------
(variables: 0, errors: 0)

--------------------------------------------------------------------------------------------
CONFIGPARAM:	(ALL CAPS) required: 
						 For "Global" CONSTANTS --- <SHONAME>_<IDENTITY>_<UNITS>_<DATATYPE>
						 For "Local" CONSTANTS  --- <IDENTITY>_<UNITS>_<DATATYPE>
-------------------------------------------------------------------------------------------
(variables: 0, errors: 0)

----------------------------
NTC SIGNALS:	<Identity>
----------------------------
(variables: 0, errors: 0)

------
OTHER:
------
(variables: 0, errors: 0)
 
************************
Grand Totals:
254 variables,  151 issues to fix.


End of Report
